{
  "1": {
    "map": [
      0, 0, 2, 5, 5, 5, 5, 2, 0, 0,
      0, 0, 2, 5, 5, 5, 5, 2, 0, 0,
      0, 0, 2, 5, 5, 5, 5, 2, 0, 0,
      0, 0, 2, 5, 5, 5, 5, 2, 0, 0,
      0, 0, 2, 5, 5, 5, 5, 2, 0, 0,
      0, 0, 2, 2, 2, 2, 2, 2, 0, 0,
      0, 0, 0, 0, 0, 0, 0, 0, 0, 0,
      0, 3, 0, 0, 0, 0, 0, 0, 4, 0,
      0, 0, 0, 1, 1, 1, 1, 0, 0, 0,
      1, 1, 1, 1, 0, 0, 1, 1, 1, 1
    ],
    "commands": [
      "self.turtle.goto(0, -70)",
      "self.turtle.write(\"Welcome to my game!\", align=\"center\", font=(\"Arial\", 12, \"normal\"))",
      "self.turtle.goto(0, -90)",
      "self.turtle.write(\"The goal is to get your character (green) to the pink square!\", align=\"center\", font=(\"Arial\", 12, \"normal\"))"
    ]
  },
  "2": {
    "map": [
      5, 5, 5, 5, 5, 5, 5, 5, 5, 5,
      2, 2, 2, 2, 2, 2, 2, 2, 2, 2,
      0, 0, 0, 0, 2, 2, 0, 0, 0, 0,
      0, 0, 0, 0, 2, 2, 0, 0, 0, 0,
      0, 0, 0, 0, 2, 2, 0, 0, 0, 0,
      0, 0, 0, 0, 1, 1, 0, 0, 0, 0,
      0, 0, 3, 0, 1, 1, 0, 4, 0, 0,
      0, 0, 0, 0, 1, 1, 0, 0, 0, 0,
      1, 1, 1, 1, 1, 1, 1, 1, 1, 1,
      5, 5, 5, 5, 5, 5, 5, 5, 5, 5
    ],
    "commands": [
      "self.turtle.goto(-150, 10)",
      "self.turtle.write(\"You can also wrap\", align=\"center\", font=(\"Arial\", 12, \"normal\"))",
      "self.turtle.goto(-150, -10)",
      "self.turtle.write(\"around the map!\", align=\"center\", font=(\"Arial\", 12, \"normal\"))"
    ]
  },
  "3": {
    "map": [
      1, 0, 0, 0, 0, 0, 0, 0, 0, 2,
      1, 0, 0, 0, 0, 0, 0, 0, 0, 2,
      1, 0, 0, 0, 0, 0, 0, 0, 0, 2,
      1, 0, 0, 0, 0, 0, 0, 0, 0, 2,
      1, 0, 0, 0, 0, 0, 0, 0, 0, 2,
      1, 0, 0, 0, 0, 0, 0, 0, 0, 2,
      1, 0, 0, 0, 0, 0, 0, 0, 0, 2,
      1, 0, 4, 0, 0, 0, 0, 3, 0, 2,
      1, 0, 0, 0, 5, 5, 0, 0, 0, 2,
      1, 1, 1, 1, 5, 5, 2, 2, 2, 2
    ],
    "commands": [
      "self.turtle.goto(0, 0)",
      "self.turtle.write(\"The red stuff is also deadly!\", align=\"center\", font=(\"Arial\", 12, \"normal\"))"
    ]
  },
  "4": {
    "map": [
      1, 0, 0, 0, 0, 2, 0, 0, 0, 0,
      1, 0, 0, 0, 0, 2, 0, 0, 3, 0,
      1, 0, 0, 0, 0, 2, 0, 0, 0, 0,
      1, 0, 0, 0, 0, 2, 2, 2, 2, 2,
      1, 0, 0, 0, 0, 0, 0, 0, 0, 0,
      1, 0, 0, 0, 0, 0, 0, 0, 0, 0,
      1, 0, 0, 0, 0, 0, 0, 0, 0, 0,
      1, 0, 4, 0, 0, 0, 0, 0, 0, 0,
      1, 0, 0, 0, 5, 5, 0, 0, 0, 0,
      1, 1, 1, 1, 1, 1, 0, 0, 0, 0
    ],
    "commands": [
      "self.turtle.goto(0, 0)",
      "self.turtle.write(\"You can also wrap vertically\", align=\"center\", font=(\"Arial\", 12, \"normal\"))"
    ]
  },
  "5": {
    "map": [
      2, 2, 2, 2, 2, 2, 2, 2, 2, 2,
      2, 0, 0, 0, 0, 0, 0, 0, 0, 3,
      2, 0, 0, 0, 1, 1, 1, 1, 1, 2,
      0, 0, 0, 0, 1, 0, 0, 0, 0, 0,
      0, 0, 1, 1, 1, 0, 0, 0, 0, 0,
      2, 1, 1, 0, 0, 0, 0, 0, 1, 2,
      2, 0, 0, 0, 0, 1, 1, 1, 1, 2,
      2, 0, 0, 0, 0, 1, 0, 0, 1, 2,
      2, 4, 0, 1, 0, 1, 0, 0, 1, 2,
      2, 2, 2, 2, 2, 2, 2, 2, 2, 2
    ],
    "commands": [
      "self.turtle.goto(10, -25)",
      "self.turtle.write(\"Anyways, have fun!\", align=\"center\", font=(\"Arial\", 12, \"normal\"))"
    ]
  },
  "6": {
    "map": [
      2, 2, 2, 0, 0, 0, 0, 0, 0, 1,
      2, 0, 0, 0, 0, 0, 0, 0, 0, 1,
      2, 0, 0, 0, 1, 1, 1, 1, 1, 1,
      0, 0, 0, 0, 1, 0, 0, 0, 0, 0,
      1, 1, 1, 1, 1, 0, 2, 2, 2, 2,
      1, 3, 0, 0, 0, 0, 0, 0, 0, 2,
      1, 0, 0, 2, 2, 0, 0, 0, 0, 2,
      1, 0, 0, 0, 0, 0, 0, 0, 0, 2,
      1, 4, 0, 0, 0, 0, 0, 0, 0, 2,
      1, 1, 1, 5, 5, 5, 0, 0, 0, 2
    ],
    "commands": [
      "self.turtle.goto(0, -150)",
      "self.turtle.write(\"Be careful!\", align=\"center\", font=(\"Arial\", 12, \"normal\"))"
    ]
  },
  "7": {
    "map": [
      2, 2, 2, 2, 0, 0, 0, 0, 0, 2,
      2, 0, 0, 0, 0, 0, 0, 0, 0, 2,
      2, 0, 0, 1, 6, 6, 6, 6, 6, 2,
      0, 0, 0, 1, 6, 5, 0, 0, 0, 0,
      2, 1, 1, 1, 6, 5, 0, 0, 0, 2,
      2, 1, 1, 1, 6, 5, 0, 0, 0, 2,
      2, 0, 0, 0, 0, 0, 0, 0, 0, 2,
      2, 0, 0, 1, 1, 1, 1, 1, 6, 2,
      2, 4, 0, 1, 5, 5, 3, 5, 5, 2,
      2, 2, 2, 2, 0, 0, 0, 0, 0, 2
    ],
    "commands": [
      "self.turtle.goto(0, 165)",
      "self.turtle.write(\"The blue ones give you a sugar rush!\", align=\"center\", font=(\"Arial\", 12, \"normal\"))"
    ]
  },
  "8": {
    "map": [
      0, 0, 5, 0, 0, 0, 0, 0, 0, 0,
      0, 0, 5, 0, 0, 0, 0, 0, 0, 3,
      0, 0, 5, 0, 0, 0, 0, 0, 0, 0,
      0, 2, 2, 2, 0, 0, 0, 0, 0, 0,
      0, 0, 0, 0, 0, 0, 0, 0, 0, 0,
      0, 4, 0, 0, 0, 0, 0, 0, 0, 1,
      0, 0, 0, 0, 0, 2, 0, 0, 0, 1,
      1, 1, 1, 0, 0, 2, 0, 0, 0, 1,
      0, 1, 0, 0, 0, 2, 0, 0, 0, 1,
      5, 1, 5, 5, 5, 2, 5, 5, 5, 1
    ],
    "commands": [
      "self.turtle.goto(0, 0)",
      "self.turtle.write(\"This one is kinda hard, but don't give up!\", align=\"center\", font=(\"Arial\", 12, \"normal\"))"
    ]
  },
  "9": {
    "map": [
      2, 2, 2, 2, 2, 2, 2, 2, 0, 2,
      2, 0, 4, 0, 1, 0, 0, 0, 0, 2,
      2, 1, 1, 0, 1, 0, 0, 0, 6, 2,
      2, 0, 0, 0, 1, 0, 0, 0, 0, 2,
      2, 0, 1, 1, 1, 0, 0, 1, 1, 2,
      2, 0, 1, 0, 0, 0, 0, 0, 0, 2,
      2, 0, 0, 0, 0, 0, 1, 1, 1, 2,
      2, 0, 0, 1, 0, 0, 1, 3, 1, 2,
      2, 0, 0, 1, 5, 5, 1, 0, 0, 2,
      2, 2, 2, 2, 2, 2, 2, 2, 0, 2
    ],
    "commands": []
  },
  "10": {
    "map": [
      1, 1, 1, 1, 1, 1, 1, 1, 1, 3,
      0, 4, 0, 0, 0, 0, 0, 0, 0, 1,
      2, 2, 2, 2, 2, 2, 2, 2, 0, 1,
      2, 0, 0, 0, 0, 0, 0, 0, 0, 1,
      2, 0, 1, 1, 1, 1, 1, 1, 0, 1,
      2, 0, 1, 0, 0, 0, 0, 1, 0, 1,
      2, 0, 1, 1, 1, 1, 1, 1, 0, 1,
      2, 0, 1, 0, 5, 0, 0, 0, 0, 1,
      2, 0, 1, 1, 1, 1, 1, 1, 1, 1,
      2, 0, 0, 0, 0, 0, 0, 0, 0, 0
    ],
    "commands": [
      "self.turtle.goto(0, -35)",
      "self.turtle.write(\"Hypnotizing\", align=\"center\", font=(\"Arial\", 12, \"normal\"))"
    ]
  },
  "11": {
    "map": [
      2, 2, 2, 0, 0, 2, 2, 2, 2, 2,
      2, 0, 0, 0, 0, 0, 0, 0, 4, 2,
      0, 0, 0, 0, 0, 0, 1, 1, 1, 2,
      0, 1, 5, 5, 5, 5, 1, 0, 0, 0,
      2, 1, 1, 1, 1, 1, 1, 0, 1, 2,
      2, 0, 0, 0, 0, 0, 0, 0, 1, 2,
      2, 0, 1, 0, 0, 1, 1, 1, 3, 2,
      0, 0, 1, 0, 0, 1, 0, 0, 0, 0,
      2, 1, 1, 0, 0, 1, 1, 1, 1, 2,
      2, 2, 2, 0, 0, 2, 2, 2, 2, 2
    ],
    "commands": []
  },
  "12": {
    "map": [
      5, 5, 0, 0, 0, 0, 0, 2, 5, 5,
      5, 1, 1, 1, 1, 1, 0, 2, 5, 5,
      0, 1, 5, 5, 5, 1, 0, 0, 0, 0,
      0, 1, 1, 1, 1, 1, 2, 2, 2, 2,
      0, 0, 0, 0, 0, 3, 0, 5, 5, 2,
      2, 2, 2, 0, 0, 0, 0, 5, 5, 2,
      5, 5, 5, 0, 0, 0, 0, 5, 5, 2,
      5, 1, 0, 0, 4, 0, 0, 5, 5, 2,
      5, 1, 0, 2, 1, 1, 2, 5, 5, 2,
      5, 1, 0, 5, 5, 5, 5, 5, 5, 2
    ],
    "commands": []
  },
  "13": {
    "map": [
      2, 0, 0, 1, 0, 0, 0, 0, 5, 2,
      2, 2, 0, 1, 1, 1, 1, 1, 5, 2,
      2, 0, 0, 1, 5, 5, 5, 5, 5, 2,
      5, 0, 1, 1, 5, 0, 0, 0, 5, 2,
      0, 0, 5, 5, 5, 0, 0, 0, 0, 0,
      2, 2, 2, 0, 0, 0, 0, 2, 2, 2,
      2, 0, 4, 0, 0, 0, 0, 2, 5, 2,
      2, 2, 2, 2, 2, 2, 2, 2, 2, 2,
      2, 0, 0, 0, 0, 5, 0, 0, 3, 2,
      2, 0, 1, 1, 0, 5, 0, 2, 2, 2
    ],
    "commands": []
  },
  "14": {
    "map": [
      0, 0, 0, 0, 0, 0, 0, 0, 0, 0,
      0, 0, 0, 0, 0, 0, 0, 0, 0, 0,
      0, 0, 3, 0, 0, 0, 0, 0, 0, 0,
      0, 0, 0, 0, 0, 0, 0, 0, 0, 0,
      0, 0, 0, 0, 0, 0, 0, 0, 0, 0,
      0, 0, 4, 0, 0, 0, 0, 0, 0, 0,
      0, 1, 1, 1, 1, 1, 0, 0, 0, 0,
      0, 1, 0, 0, 0, 1, 0, 0, 0, 0,
      0, 1, 0, 0, 0, 1, 5, 5, 5, 0,
      0, 0, 0, 0, 0, 0, 0, 0, 0, 0
    ],
    "commands": [
      "self.turtle.goto(0, 0)",
      "self.turtle.write(\"Impossible!\", align=\"center\", font=(\"Arial\", 12, \"normal\"))"
    ]
  },
  "15": {
    "map": [
      1, 3, 1, 5, 0, 0, 0, 0, 1, 0,
      1, 3, 1, 5, 0, 2, 2, 0, 1, 0,
      1, 3, 1, 0, 0, 2, 0, 0, 1, 0,
      1, 3, 1, 0, 2, 2, 0, 0, 1, 0,
      3, 3, 1, 0, 0, 2, 0, 5, 1, 0,
      1, 3, 1, 2, 0, 2, 0, 5, 0, 0,
      1, 3, 1, 0, 0, 2, 0, 5, 1, 0,
      1, 3, 1, 0, 2, 2, 0, 0, 0, 0,
      1, 3, 1, 4, 2, 2, 0, 0, 0, 1,
      1, 3, 1, 2, 2, 2, 2, 2, 2, 2
    ],
    "commands": []
  },
  "16": {
    "map": [
      4, 0, 0, 0, 0, 5, 2, 0, 5, 1,
      2, 0, 5, 0, 1, 0, 5, 1, 2, 0,
      5, 1, 0, 0, 0, 0, 0, 5, 0, 2,
      0, 0, 0, 2, 1, 5, 0, 2, 1, 0,
      2, 0, 1, 0, 5, 2, 1, 5, 0, 0,
      1, 0, 0, 0, 1, 1, 2, 0, 0, 0,
      0, 2, 5, 0, 0, 1, 0, 0, 0, 2,
      1, 0, 0, 0, 0, 5, 0, 2, 5, 0,
      3, 5, 1, 2, 0, 5, 0, 0, 0, 0,
      1, 2, 0, 5, 1, 2, 1, 0, 1, 0
    ],
    "commands": []
  },
  "17": {
    "map": [
      0, 0, 0, 0, 0, 0, 0, 0, 0, 0,
      0, 5, 2, 5, 1, 0, 1, 5, 1, 1,
      2, 2, 0, 0, 0, 1, 0, 0, 0, 1,
      2, 0, 0, 0, 0, 0, 0, 0, 0, 0,
      2, 4, 0, 0, 0, 0, 0, 0, 0, 0,
      2, 2, 5, 5, 5, 1, 5, 5, 5, 0,
      2, 2, 2, 2, 2, 0, 1, 1, 1, 0,
      0, 0, 0, 0, 0, 0, 0, 0, 0, 0,
      0, 1, 1, 0, 0, 1, 0, 0, 1, 1,
      0, 1, 1, 5, 5, 1, 5, 5, 3, 1
    ],
    "commands": []
  },
  "18": {
    "map": [
      1, 4, 0, 1, 0, 0, 1, 0, 0, 1,
      1, 1, 0, 1, 1, 0, 1, 1, 0, 1,
      1, 0, 0, 1, 0, 0, 1, 0, 0, 1,
      1, 0, 0, 1, 0, 0, 1, 0, 0, 1,
      1, 0, 5, 1, 0, 5, 1, 0, 5, 1,
      1, 0, 0, 1, 0, 0, 1, 0, 0, 1,
      1, 1, 0, 5, 1, 0, 5, 1, 0, 5,
      1, 5, 0, 5, 5, 0, 5, 5, 0, 5,
      1, 5, 0, 0, 5, 0, 0, 5, 0, 3,
      1, 1, 1, 0, 0, 1, 0, 0, 1, 1
    ],
    "commands": []
  },
  "19": {
    "map": [
      2, 0, 0, 0, 0, 0, 0, 0, 0, 0,
      2, 2, 2, 2, 2, 2, 0, 0, 0, 0,
      0, 0, 0, 0, 0, 0, 0, 0, 0, 0,
      0, 1, 1, 1, 1, 1, 1, 1, 1, 1,
      0, 1, 0, 0, 0, 0, 0, 0, 0, 0,
      1, 1, 0, 0, 0, 0, 2, 2, 2, 2,
      0, 0, 0, 0, 0, 0, 2, 0, 0, 5,
      0, 0, 0, 1, 0, 0, 2, 0, 0, 5,
      0, 4, 0, 1, 0, 0, 0, 0, 0, 5,
      1, 1, 1, 1, 1, 1, 1, 1, 5, 3
    ],
    "commands": [
      "self.turtle.goto(0, 15)",
      "self.turtle.write(\"Y'know, hitboxes are kinda funny\", align=\"center\", font=(\"Arial\", 12, \"normal\"))"
    ]
  },
  "20": {
    "map": [
      5, 5, 5, 5, 5, 5, 5, 5, 0, 0,
      0, 0, 0, 0, 0, 0, 0, 0, 0, 0,
      0, 0, 0, 0, 0, 0, 0, 0, 0, 6,
      0, 0, 0, 0, 0, 0, 0, 0, 6, 0,
      1, 6, 6, 6, 6, 1, 1, 6, 5, 0,
      5, 5, 5, 5, 5, 5, 5, 5, 0, 0,
      0, 0, 0, 0, 0, 0, 0, 0, 0, 0,
      0, 0, 0, 0, 0, 0, 0, 0, 0, 6,
      0, 4, 0, 0, 0, 0, 0, 0, 1, 3,
      1, 1, 6, 6, 1, 6, 6, 6, 3, 3
    ],
    "commands": []
  },
  "21": {
    "map": [
      0, 0, 0, 0, 0, 0, 0, 0, 0, 0,
      6, 0, 0, 0, 1, 1, 1, 1, 1, 1,
      0, 0, 0, 0, 1, 5, 5, 5, 5, 5,
      0, 0, 0, 0, 1, 5, 0, 0, 0, 0,
      0, 0, 0, 0, 1, 5, 0, 0, 0, 0,
      1, 1, 1, 6, 1, 5, 0, 0, 0, 1,
      1, 5, 5, 5, 5, 5, 0, 0, 0, 0,
      0, 0, 0, 0, 0, 0, 0, 1, 0, 0,
      0, 0, 4, 0, 0, 0, 0, 1, 0, 0,
      0, 1, 1, 1, 1, 1, 1, 1, 0, 0
    ],
    "commands": [
      "self.turtle.goto(-50, -150)",
      "self.turtle.write(\"You win!\", align=\"center\", font=(\"Arial\", 12, \"normal\"))"
    ]
  }
}